cols 9
rows 6
layer buildings_beige
5 6 6 7 6 6 6 6 8
18 59 59 59 59 59 19 59 21
18 19 59 19 59 59 19 59 59
18 59 59 59 59 59 59 59 59
18 59 19 59 59 59 59 19 21
31 32 32 32 32 32 33 32 34
colliders
8.5 0 0.5 2
0 0 8.5 0.5
0 0.5 0.5 5.5
0.5 5.5 8.5 0.5
8.5 4 0.5 1.5
